sci=SCI收录
ei=EI收录
istp=ISTP收录
core=中文核心期刊或外文期刊
international=国际会议
normal=普通期刊
nation=国家会议
province=省级会议

zz=专著
bz=编著
yz=译著
hb=省、院汇编
nbqk=内部期刊


nation1=国家级一等
nation2=国家级二等
province1=省部级一等
province2=省部级二等
province3=省部级三等
city1=厅市级一等
city2=厅市级二等
city3=厅市级三等

videonation=国家级
videoprovince=省级
videoweb=网络

centertv=中央电视台
hbtv=河北省电视台

goveragree=省级
tleaderagree=厅级
tchuagree=省科技厅处级

nationstudy=国家级研究项目
nationwork=国家级工作项目
provincestudy=省级研究项目
provincework=省级工作项目
citystudy=厅市级科研项目
hproject=横向项目

foreigninvent=国际发明专利
invent=国内发明专利
applied=实用新型专利
software=软件著作权
outer=外观设计专利



nationys_=国际领先
provinceys_=国际先进
inadvance=国内领先
inpro=国内先进

nationys=国家级验收
provinceys=省级验收
normalys=正常结题

nationmeeting=国家级学会学术年会
provincemeeting=省级学会学术年会
interprovince=省际学术研讨会
majormeeting=省内专业学术研讨会

host=主办
undertake=承办
help=协办



reportgov=省级
reportting=厅级
reportscience=省科技厅处级


